<2022.05.05일자 공부 기록>

1. 영단어 외우기
	superb - 최고의, 뛰어난, 멋진
	superior - 우수한, 상급의, 우세한
	superficial - 표면상의, 피상적인, 얄팍한
	superfluous - 남아도는, 불필요한
	supernatural - 초자연적인
	surface - (넓은 땅, 물의)표면, 외관
	surplus - 과잉, 흑자
	surprise - 뜻밖의 소식, 놀라운 일
	surrender - 항복하다, 투항하다, 포기하다
	surround - 둘러싸다, 포위하다
	survey - (설문)조사, 측량, 점검
	perfect - 완벽한, 완전한
	perform - 공연하다, 수행하다, 성취하다
	permanent - 영구적인, 영원한
	persevere - 인내하다, 계속하다, 노력하다
	persuade - 설득하다, 재촉하다
	enable - 가능하게 하다, 할 수 있게 하다
	encourage - 용기를 북돋우다, 장려하다
	endanger - 위험에 빠뜨리다, 위태롭게 하다
	enlarge - 확대하다, 늘리다
	enrich - 부유하게 하다, 풍부하게 하다
	ensure - 반드시 ~하게 하다, 보장하다, 확보하다
	entitle - 자격을 주다, 제목을 붙이다
	embark - 승선하다, 싣다, 시작하다, 착수하다
	empower - 권한(권리)을 주다, 할 수 있게 하다	
	alike - 비슷한, 동등한
	ashamed - 부끄러운, 수치스러운
	amaze - 놀라게 하다
	arise - 발생하다, 일어나다
	asocial - 비사교적인, 반사회적인, 이기적인
	apolitical - 정치에 무관심한, 정치를 싫어하는


2. 학교 공부 필기
	<C++ 프로그래밍>
	- 다형성
		> 객체 타입이 다르면 똑같은 메시지가 전달되더라도 서로 다른 동작을 하는 것.


	- 객체 포인터의 형변환
		> 상향/하향 형변환
		(자식, 부모 클래스 간의 타입 변환)


	- 동적 바인딩
		> 컴파일 단계에서 모든 바인딩이 완료되는 것이 정적 바인딩(보통 일반 함수)
		> 바인딩이 실행 시까지 연기되고 실행 시간에 실제 호출되는 함수를 결정하는 것이 동적 바인딩이다.
		(보통 가상 함수에 해당)


	- 추상 클래스(순수 가상 함수를 하나라도 가지고 있는 클래스)
